Ligabue|Non cambierei questa vita con nessun'altra
SEBASTIAN YATRA WITH JOHN LEGEND|Tacones Rojos
La rappresentante di lista|Diva
Pinguini Tattici Nucleari|Giovani Wannabe
Ultimo|Vieni nel mio cuore
Irama|PAMPAMPAMPAMPAMPAMPAMPAM
Nic D|Icee Pop
Fabri Fibra ft. Colapesce e Dimartino|Propaganda
Harry Styles|As It Was
Alvaro Soler X Topic |Solo Para Ti
Imagine Dragons|Bones
Takagi & Ketra|BUBBLE (feat. thasup & Salmo)
Franco126 e Loredana Bertè|Mare Malinconia
Follya|tutt'okkei
Malika Ayane|Una Ragazza
BLANCO|Nostalgia
Francesco Gabbani|Volevamo solo essere felici
Camila Cabello ft. Ed Sheeran|Bam Bam
Carl Brave e Noemi|HULA-HOOP
Sfera Ebbasta & Rvssian|Mamma Mia
Lizzo|2 Be Loved (Am I Ready)
The Weeknd|Out of Time
Doctum|Whip
Vasco Rossi|L'Amore L'Amore
Fedez, Tananai, Mara Sattei|LA DOLCE VITA
Ghali|PARE (feat. Madame)
Baby K ft. Mika|Bolero
Eros Ramazzotti|AMA
BoomDaBash|Tropicana ft. Annalisa
Coez|Essere liberi
Calvin Harris|Stay With Me (feat. Justin Timberlake, Halsey & Pharrell Williams)
The Kolors|BLACKOUT
Elisa|Litoranea (con Matilda De Angelis)
Cesare Cremonini|Chimica
Biagio Antonacci|Seria
Vlossom|Take Another Minute
Francesca Michielin|bonsoir
Gianni Morandi|LA OLA
David Guetta|Crazy What Love Can Do (feat. Backy Hill & Ella Handerson)
ED SHEERAN FT. ULTIMO|2step
Kungs|Clap Your Hands
Rhove|Shakerando
James Hype|Ferrari (feat. Miggy Dela Rosa)
Imagine Dragons|Sharks
Lady Gaga|Hold My Hand
Sangiovanni|scossa
Lizzo|About Damn Time
Måneskin|SUPERMODEL
Bob Sinclar & Nyv|Borderline
Marco Mengoni|No Stress
Robbie Williams|Lost
Myss Keta|FINIMONDO
Madame|L’Eccezione
Fred De Palma|Extasi
Benny Blanco, BTS, Snoop Dogg|Bad Decisions
Marshmello|Numb (feat. Khalid)
Machine Gun Kelly|make up sex
Calvin Harris, Dua Lipa & Young Thug|Potion
Post Malone|I Like You (A Happier Song - feat. Doja Cat)